    0_1_2_3_4_5_6_7_8_9_0_1_2_3_4_5_6_7_8_9
0 | . . . . . . . . . .|. . . . . . . . . . | 0
1 | . . . . . . . . . .|. . . . . . . . . . | 1
2 | . . . . . . . . . .|. . . . . . . . . . | 2
3 | . . . . . . . . . .|. . . . . . . . . . | 3
4 | . . . . . . . . . .|. . . . . . . . . . | 4
5 | . . . . . . . . . .|. . . . . . . . . . | 5
6 | . . . . . . . . . .|. . . . . . . . . . | 6
7 | . . . . . . . . . .|. . . . . . . . . . | 7
8 | . . . . . . . . . .|. . . . . . . . . . | 8
9 |_._._._._._._._._._.|._._._._._._._._._._| 9
0 | . . . . . . . . . .|. . . . . . . . . . | 0
1 | . . . . . . . . . .|. . . . . . . . . . | 1
2 | . . . . . . . . . .|. . . . . . . . . . | 2
3 | . . . . . . . . . .|. . . . . . . . . . | 3
4 | . . . . . . . . . .|. . . . . . . . . . | 4
5 | . . . . . . . . . .|. . . . . . . . . . | 5
6 | . . . . . . . . . .|. . . . . . . . . . | 6
7 | . . . . . . . . . .|. . . . . . . . . . | 7
8 | . . . . . . . . . .|. . . . . . . . . . | 8
9 | . . . . . . . . . .|. . . . . . . . . . | 9
    0_1_2_3_4_5_6_7_8_9_0_1_2_3_4_5_6_7_8_9